############################################################
#                                                          #
#                                                          #
#                                                          #
#   #   #######   ########################   #######   #   #
#   #   #                                          #   #   #
#   #   #                                          #   #   #
#   #   #                                          #   #   #
#   #   #   ####################################   #   #   #
#   #   #                    #                     #   #   #
#   #   #                    #                     #   #   #
#   #   #                    #                     #   #   #
#   #       ###   ########   #   #########   ###       #   #
#   #       #                                  #       #   #
#   #       #                                  #       #   #
#   #   #   #                                  #   #   #   #
#   #   #   #   ############   #############   #   #   #   #
#   #   #   #   #                          #   #   #   #   #
#   #   #   #   #                          #   #   #   #   #
#   #   #   #   #                          #   #   #   #   #
#   #   #   #   #                          #   #   #   #   #
#   #   #   #   #                          #   #   #   #   #
#   #   #   #   #                          #   #   #   #   #
#   #   #   #   ############################   #   #   #   #
#   #   #   #                                  #   #   #   #
#   #       #                                  #       #   #
#   #       #                                  #       #   #
#   #       ###   ########################   ###       #   #
#   #   #                                          #   #   #
#   #   #                                          #   #   #
#   #   #                                          #   #   #
#   #   #   ################   #################   #   #   #
#   #   #                                          #   #   #
#   #   #                    p                     #   #   #
#   #   #                                          #   #   #
#   #   #######   ########################   #######   #   #
#                                                          #
#                                                          #
#                                                          #
############################################################